__     __                    _       _ 
\ \   / /                   (_)     | |
 \ \_/ /__  _   _  __      ___ _ __ | |
  \   / _ \| | | | \ \ /\ / / | '_ \| |
   | | (_) | |_| |  \ V  V /| | | | |_|
   |_|\___/ \__,_|   \_/\_/ |_|_| |_(_)
                                       
